CARAT           OFFICE
CRUCIBLE        OFFICE
ANVIL           OFFICE
FORGE           OFFICE
KILN            OFFICE
TONGS           OFFICE
GILD            OFFICE
FURNACE         OFFICE
VICE            OFFICE
HAMMER          OFFICE
SAPELE          LIVING
MAPLE           LIVING
IROKO           LIVING
CEDAR           LIVING
MAHOGHANY       LIVING
OBECHE          LIVING
WILLOW          LIVING
BALSAM          LIVING
JUNIPER         LIVING
OLIVE           LIVING